####################################################################
#                                                                  #
#                                                                  #
#                                                                  #
#                                                                  #
#                                                                  #
#                                                                  #
#                                                                  #
#                                                                  #
#                                                                  #
#                                                                  #
#                                                                  #
#                                                                  #
#                       #############                              #
#                       #           #                              #
#                       #       @   #                              #
#                       #           #                              #
#                       #############                              #
#                                                                  #
#                                                                  #
#                                                                  #
#                                                                  #
#                                                                  #
####################################################################