[-------------------------------------------]
I___________________________________________I
I____[------]_______________________________I
I____I      I_______________________________I
I____I  @   I_______________________________I
I____L--P---/_______________________________I
I_______&_____________[---------]___________I
I_______&_____________I       E I___________I
I_______&_____________I         I___________I
I__~~~__&&&&&&&&&&&&&&P         I___________I
I_~~~~~_______________I         I___________I
I_~~~~~~~~~~~~~~~~____I         I___________I
I__~~~~   ~~~~~_______I      o  I___________I
I___~~~~ C ~~~~~______L--P------/___________I
I__~~~~~  ~~~~~~~________&__________________I
I__~~~~~~~~~~~  P&&&&&&&&&__________________I
L-------------------------------------------/