[-------------------------------------------]
|___________________________________________|
|____[------]_______________________________|
|____|      |_______________________________|
|____|  @   |_______________________________|
|____L--P---/_______________________________|
|_______&_____________[---------]___________|
|_______&_____________|       E |___________|
|_______&_____________|         |___________|
|_______&&&&&&&&&&&&&&P         |___________|
|_____________________|         |___________|
|_____________________|      o  |___________|
|_____________________L---------/___________|
|___________________________________________|
|___________________________________________|
L-------------------------------------------/