              ############################# 
              #                         E # 
              # ####################   #### 
              # #                  #   #    
       ########P#########          #   #    
       #                #          #   #    
       #               #           #   #    
       #               #           #   #    
       #              #            #   #    
        #     @      #             # o #    
         #          #              #   #    
          ##########               #   #    
                                   #   #    
             #######################   #    
             #  M                      #    
             ###########################    
                                            
                                            