####################################################################
#                                                                  #
#                                                                  #
#                                                                  #
#                                                                  #
#                                                                  #
#                                                                  #
#                                                                  #
#                                                                  #
#                                                                  #
#                                                                  #
#                                                                  #
#                                                                  #
#                                                                  #
#                                                                  #
#                              @                                   #
#                                                                  #
#                                                                  #
#                                                                  #
#                                                                  #
#                                                                  #
#                                                                  #
#                                                                  #
####################################################################